##########
##...#...#
#..#...#.#
#.###.#..#
#..#..####
#.#..#...#
#..#...#.#
#s..###e.#
###....#.#
##########
