###############
###############
#.#.....#.....#
#.#.###.#.#.###
#.#.#...#.#...#
#.#.#####.###.#
#...#...#...#.#
#.#####.###.#.#
#.....#.#...#e#
#####.#.#.###.#
#....s#.....#.#
#.###########.#
#.............#
###############
###############
