##########
##.....s.#
##.#####.#
##e#.....#
##.#####.#
##.....#.#
##.###.###
##...#...#
##########
##########
