#########################
##.........#..#....#.#e.#
#..#.#.###...#..##....#.#
#.##..#...###.#.#.##.##.#
#...#.#.#.....#.#..#.#..#
#.#..##..###.#..#.#..#.##
#..#.#..#..#..#.#.#.#..##
##.#...#..#..##.#.#.#.#.#
#...###.#.#.#...#.#...#s#
##.#......#...###..##.#.#
#..#.####.####...#...#..#
#.#..#..#......#.#.#...##
#.#.#.#..#.###.#.#..#.#.#
#.#.....#..#...#..#.#...#
#.#.#.##.##..##.#..####.#
#.#..#......#....#..#...#
#..#.#.#####..##...#..#.#
##..##.#...#.#..###..#..#
#.#....#.##..##....#.#.##
#..#####..#.#...##....#.#
##.......#..#####..##.#.#
#.#.#.####.#.....##.#...#
#...##.....##.##.#...##.#
#.#....#.#....#....#....#
#########################
