##################################################
##################################################
#...#.......#.....#...........#...............#.##
#.###.###.#.#.###.#######.###.#####.#########.#.##
#.#...#.#.#.#...#.#.....#...#.....#.#...#...#...##
#.#.###.#.#####.#.#.###.###.#####.#.#.#.#.#.######
#.#...#.#.......#...#.#...#...#...#.#.#...#.....##
#.###.#.#######.#####.###.#.#.#.###.#.#########.##
#...#.....#...#.....#.#...#.#.#...#.#.....#.#...##
#.#.#####.#.#.#####.#.#.#####.###.#.#####.#.#.####
#.#.#...#.#.#.....#...#.....#...#...#.....#.#...##
#.#.#.#.#.#.#####.#.#######.###.#####.#####.###.##
#.#.#.#.#.#.#...#.#.#...#...#...#.....#.....#...##
###.#.#.#.#.#.###.###.#.#.###.###.#####.#####.####
#...#.#...#.#...#...#.#.#...#.....#.........#...##
#.###.#####.###.#####.#.###.###.###########.###.##
#...#...#.#.....#.....#...#...#.............#...##
#.#.###.#.#####.#.#######.#.#.###############.#.##
#.#...#.#.....#...#.#...#.#.#.....#.........#.#.##
#.###.#.###.#######.#.#.#.#####.#.#.#######.#.#.##
#...#.#...#.....#...#.#.#.....#.#.#.#...#...#.#.##
#.###.###.###.###.#.#.#.#####.###.#.#.###.###.####
#.#...#.#...#.....#...#.....#...#...#.#...#.....##
#.#.#.#.###.#######.###.###.###.###.#.#.#######.##
#.#.#.....#.......#...#.#...#.#...#...#.#...#...##
#.#.#############.#####.###.#.###.###.#.#.#.#.####
#.#...#.........#.....#...#.#...#.#...#...#.#...##
#.###.#.#####.#.#####.###.#.#.#.#.#########.###.##
#...#...#...#.#.....#...#.#...#.#...........#...##
###.#####.#.#.#####.###.#.#####.#############.####
#...#.....#.#.#.......#...#...#.#.....#...#.....##
#.###.#####.#.#######.#####.#.#.#.###.#.#.#.###.##
#...#...#...#.......#...#.#.#.#...#...#.#.#...#.##
###.###.#.#########.###.#.#.#.#####.###.#.#####.##
#.#...#.#...#...#...#.....#.#.....#.#...#.......##
#.###.#.###.###.#.#####.###.#.###.#.###.#######.##
#...#...#.#...#.#.#...#.#...#...#.#.....#.....#.##
#.#.#####.###.#.#.#.#.#e#.#####.#.#######.#.###.##
#.#.........#...#...#.#.#.#...#.#.......#.#.....##
#.#######.#####.#####.#.#.###.#.#####.###.########
#.#.#.....#...#.#.s.#.#.#...#.#.#...#.#...#.....##
#.#.#.###.#.#.#.#.#.#.#####.#.#.#.#.#.#.###.###.##
#...#...#.#.#.#...#.#.....#.#.#...#.#.#.#.....#.##
###.###.#.#.#.#####.#####.#.#.#####.###.#.###.#.##
#.#...#.#.#.#.....#.#...#...#.....#.....#...#.#.##
#.###.#.#.#.###.###.###.#######.#.###########.#.##
#.....#.#.#.#.#.....#...#.....#.#.............#.##
#.#####.###.#.#######.#.###.#.###.#############.##
#.....#...............#.....#.....#.............##
##################################################
