##########
##########
##.#.....#
##.#.###.#
##...#s..#
######e#.#
##.....#.#
##.#####.#
##.#.....#
##########
