##################################################
#.......#.........#...#.......#.........#...#...##
#.#######.###.###.#.#.#.#####.#######.#.#.#.#.#.##
#.....#...#.#...#...#.#...#.#.....#...#...#.#.#.##
#####.#.###.###.#####.#.#.#.#####.#.#######.#.#.##
#...#.....#...#.#.#...#.#.#.....#.#...#...#.#.#.##
#.#.#####.#.###.#.#.#####.###.#.#.#.#.#.#.#.#.#.##
#.#.....#...#...#.....#...#...#.#.#.#.#.#.#...#.##
#.#####.###.#.#######.#.###.#####.#.#.#.#.#####.##
#.#...#.#...#.#...#.#.#.#...#.....#.#...#.#.....##
#.#.#.#.#.###.#.#.#.#.#.#.#.#.#####.#####.#.######
#...#.#.#.#...#.#.#.....#.#.#.#.....#.....#.#...##
#.###.#.#.#.#.#.#.#######.###.#.#####.#####.#.#.##
#.#.#.#.#.#.#.#.#...#.........#.....#.#...#.#.#.##
#.#.#.#.###.#.#.###.#####.###########.#.#.#.#.#.##
#...#.#.#...#.#...#.#...#.............#.#.#...#.##
#####.#.#.###.#.###.#.#.###############.#.#####.##
#.....#...#.#.#.#...#.#.#...#.....#.....#.#.....##
#.#########.#.#.#.###.#.#.#.###.#.#.#####.#.######
#.....#.......#.#.....#...#.#...#.#.#...#...#...##
#.###.#######.#.###########.#.#####.###.#######.##
#...#.......#.#.#.......#.#.#.#.................##
###.#######.###.#####.#.#.#.#.#.#########.########
#.#...#...#...#.......#.#.#.#.....#.....#.#.....##
#.###.#.#.###.#########.#.#.#.#####.###.###.###.##
#...#.#.#...#...#.........#.#.#.....#.#.....#s..##
#.#.#.#.#######.#.#########.#.#.#####.#######.####
#.#.#.#...#...#.#.#...#.....#.#.....#.......#...##
###.#.#.#.#.#.#.#.#.###.#####.#####.#.#.#######.##
#...#.#.#.#.#...#...#...#...#.....#.#.#.#.......##
#.###.#.#.#.#######.#.###.###.#######.#.#.########
#.#...#.#.#.#.....#.#...#.....#.......#.#.#.....##
#.#.#####.#.#.#.###.###.#####.#.###.###.#e#####.##
#...#.....#.#.#.......#.....#.#.#...#...#.#.....##
#.###.#####.#.#############.#.#.#.###.###.#.######
#.#.....#...#.....#.........#.#.#...#.#...#.....##
#.#####.#.#.#####.#.###########.###.#.#.###.###.##
#...#...#.#.....#.#...#.........#.#.#.#...#...#.##
###.#.###.#######.###.#.#########.#.#####.#####.##
#.#.#.#...#.....#.#.#...#...#.....#.....#.#...#.##
#.#.#.#.###.###.#.#.#####.#.#####.###.###.#.#.#.##
#.#.#.#...#.#.#...#.......#.#...#...#...#...#.#.##
#.#.#.###.#.#.#####.#.#####.#.#.#.#####.#####.#.##
#.#.....#.#.......#.#.#...#...#.#.....#...#...#.##
#.#.#####.#######.###.#.#######.#.###.###.#.###.##
#...#...........#...#.#.......#.#...#...#.#.....##
#.###.#############.#.#.#####.#.#####.#.#.#####.##
#...#.................#.....#.........#.#.......##
##################################################
##################################################
