##################################################
#........e......#.............#.........#.....#.##
#######.###.###.#.#.#########.#.#.#####.###.#.#.##
#.....#...#.#.#...#.#.......#.#.#.#.....#...#...##
#.###.#.###.#.#####.#.#####.#.#.#.#####.#.#####.##
#.#...#.#...#.......#...#.#.#.#.#.....#...#...#.##
#.#.#####.###.#########.#.#.###.#####.#####.###.##
#.#.#.....#.....#.....#.#.#.....#.....#...#.....##
#.#.#.#####.#####.#.#.#.#.#######.#####.###.######
#.#...#...#.#.#...#.#.#...#.......#.#.......#...##
#.#####.#.#.#.#.###.#####.#.#######.#.#######.#.##
#...#...#.#...#.#.#.#.....#.#.......#.#.#.....#.##
###.#.###.#####.#.#.#.#####.#####.#.#.#.#.#####.##
#...#.#.#.........#.....#...#...#.#...#.#.....#.##
#.###.#.###########.#####.#.#.#####.###.#####.#.##
#...#.#.......#...#...#...#.#.....#...#.....#.#.##
###.#.#.#######.#.#####.#.#######.###.#.###.#.#.##
#...#.#.#.......#...#...#.#.......#.#.#.#.#...#.##
#.#.#.#.#.#########.#.###.#.#######.#.#.#.#####.##
#.#.#...#.........#.#.#...#...#.....#.#...#.....##
#.#####.#######.#.#.#.#######.###.###.###.#.###.##
#.#.....#.....#.#.#...#.....#...#...#...#.#.#.#.##
#.#.#####.###.###.#####.###.###.#.#.###.###.#.#.##
#...#...#...#...#.#.....#.#...#.#.#...#...#.#...##
#.###.#.###.###.#.#.#####.###.#.#.#.#.###.#.#.####
#.#...#.#...#.....#.#.......#...#.#.#...#.#.#...##
#.#.###.#.#########.#.###.#######.#.#####.#.######
#.#...#...#.......#.#...#.........#...#...#.....##
#.###.#####.#####.#.###.#############.#.#######.##
#...#.....#.....#.#.#...s...........#.#.......#.##
###.#####.#####.#.#.#############.###.#######.#.##
#...#.........#.#...#...#.......#.#...#.....#...##
#####.#########.#####.#.#.#####.#.#.#.#.###.###.##
#...#.#.........#.#...#.#.#.....#.#.#.#.#...#...##
#.#.#.#.#########.#.#.#.#.#####.###.#.###.#.#.####
#.#...#...#...#.....#.#...#...#...#.#.....#.#...##
#.#######.#.#.#.#####.#####.#.###.#.###.#######.##
#.......#.#.#.#.#...#.......#.#.#...#...#.......##
#.#####.#.###.#.#.#.###.#####.#.#.#######.########
#.#...#.#...#...#.#...#.#.....#.#.#.......#.....##
#.#.###.###.#####.###.###.#####.#.#.#########.#.##
#.#...#...#.....#.#.......#...#...#.#.........#.##
#.###.#.#######.#.#####.###.#.#####.#.#########.##
#.....#.......#.#.....#.#...#.....#.#.......#...##
#####.###.#####.###.#.###.#######.#.#.#####.#.####
#.....#.#.#...#...#.#.#...#...#.#...#.#...#.#.#.##
#.#####.#.#.#.###.#.#.#.###.#.#.#######.#.#.#.#.##
#.......#...#.....#.#.......#...........#...#...##
##################################################
##################################################
