#########################
#....#......#...#..##...#
#.##.##.#.#...#..#....#.#
#.#....#..##.#.#..#.###.#
#.##.#.#.#..#...#.##....#
#...##...#.#..#.#..#.##.#
#.#...#.#...#.#..#.#.#..#
##..#..#..#...#.#..#..#.#
#..#.#.#.#####..#.#.#.#.#
##...#..#.#...#.#.#....##
#.#.#.#.....#.#.#.#.##..#
#.#....#.###..#.#.#..##.#
#..#.#..##...#..#.##..#.#
##....##...##..##...#.#.#
#.####...##...#..##.#.#.#
#......##...#...#....#..#
#.#.###.#.#.#.#..#.#...##
#..#.....#..#.##..#.##..#
##.#.#.#.#.##..#.#...##.#
#.....#..#...##..#.#..#.#
####.#..##s#...###..#...#
#...#..#...###....#.#.###
#.#...##.##...###....#..#
#.e#.#......#....#.#...##
#########################
