##################################################
##...........#.......................#...........#
##.#.#######.#.#############.#######.###.#######.#
##.#.#.......#.#...#.......#.......#...#...#...#.#
##.#.#########.#.#.#####.#.#######.###.#####.#.#.#
##.#.....#...#.#.#.....#.#.......#...#.......#.#.#
##.#####.#.#.#.#.#####.#.#####.#.###.#########.#.#
##.#.#...#.#.#...#.....#.#.....#.#...#.....#.#...#
##.#.#.###.#.#####.#######.#.#####.###.###.#.###.#
##.#.#.....#.#...#.#.......#.#...#.#...#.#.#.....#
##.#.#######.#.#.#.#.#########.#.#.#.###.#.#####.#
##.#.....#.#...#.....#.....#e..#...#.#...#.....#.#
##.#.###.#.###########.###.#.#######.#.#.#####.#.#
##.#.#...#.....#...#...#.#.#.#.......#.#...#...#.#
##.#.#.###.###.#.#.#.###.#.#.#.###########.#######
##...#.....#.#...#.#.#...#.#.#...#...#...s.......#
############.#.#####.#.###.#.###.#.#.#.#########.#
##.#.....#.....#.....#...#.#...#.#.#...#.......#.#
##.#.###.#.#####.#######.#.#.#.#.#.#####.#####.#.#
##...#.#...#...#...#.....#...#.#...#...#...#...#.#
##.###.#####.#.###.#.###.#####.#####.###.#.###.#.#
##.......#...#.....#.#.......#...#...#...#...#.#.#
########.#.###.#####.#.#########.#.###.#####.#.#.#
##.....#.#...#.#...#.#.#.......#.#.........#.#.#.#
####.#.#.###.###.#.#.#.#.#####.#.###########.#.#.#
##...#.#...#.....#.#.#.#.#...#...#...........#.#.#
##.###.###.#######.#.###.#.#.###.#.###########.#.#
##...#...#.......#.#.....#.#...#...#...#.......#.#
##.#.###########.#.#####.#.###.#####.#.#.#######.#
##.#...#.....#...#.....#.#.#...#.....#.#.#.....#.#
######.#.#.###.#######.###.#.###.#####.#.#####.#.#
##.....#.#.....#.....#.#...#...#.....#.........#.#
##.#####.#########.###.#.#####.#.#############.#.#
##.......#.........#...#.#...#.#.#.......#.....#.#
##.#######.#.#####.#.#.#.###.#.#.#.#####.#.#####.#
##.#.......#...#...#.#.#...#.#.#.#.....#.#...#...#
##.#.#####.###.#####.#.###.#.#.#####.###.###.#.###
##.#.#...#...#...#...#...#...#...#...#...#...#...#
##.###.#.#######.#.#########.###.#.###.#####.###.#
##.....#.........#...#.....#.#.#...#.#.....#...#.#
################.###.#.###.#.#.#####.#####.#####.#
##.....#.........#.#...#.#...#...#.......#.....#.#
####.#.#.#########.#####.#######.#.###.#.#####.#.#
##...#.#.....#...#...#...#.....#.#...#.#.#.#...#.#
##.#########.#.#.###.#.#.#.#.#.#.###.#.#.#.#.###.#
##...#.......#.#...#...#...#.#.#.....#.#.#.#.#...#
##.#.#.#######.###.#########.#.#######.#.#.#.#.###
##.#...........#.............#.........#...#.....#
##################################################
##################################################
