##################################################
##################################################
##.....#.......#...#...........#.......#.......#.#
##.#####.#.#####.#.###.#####.#.#.#.###.#.#####.#.#
##.#.....#.#.....#...#.#...#.#...#...#...#...#...#
##.#.#####.#.#######.#.#.#.#####.###.#####.#####s#
##.#...#...#...#...#.#.#.#.....#.#.#.#.....#...#.#
##.###.#.#####.###.#.#.#.#####.#.#.#.#.#####.#.#.#
##...#.#.#.........#.#.#...#...#...#.#...#...#...#
##.###.#.#.#########.#####.#.#######.###.#.#######
##.#...#.#.#...#.....#.....#.........#...#.......#
##.#.###.#.#.#.#.#####.###############.#####.#####
##...#.#...#.#.#.#.....#...#...#.......#.....#...#
##.###.#####.#.#.#.#.###.###.#.#.#.###.#.#####.#.#
##.#.....#...#...#.#.#.#.....#...#.#...#.#.....#.#
##.#.#####.#######.#.#.#.#########.###.#.#.#####.#
##.#.#.....#...#...#.#.....#...#.#...#.#.#.#.....#
##.#.#######.#.#.###.#####.#.#.#.###.###.#.#.###.#
##.#.....#.#.#.#...#.#...#...#.#...#.....#.#.#...#
##.#.###.#.#.#.###.#.#.#.#####.#.#########.#.#####
##...#.#.#...#.....#.#.#...#.....#.........#.....#
######.#.#####.#####.#.###.#######.#############.#
##.....#.....#.#...#.#...#.#.......#.......#.....#
######.#####.#.#.#.#.#.###.#.#########.#####.###.#
##.........#.#...#.#.#.#...#...#.......#...#.#.#.#
##.#########.#.#####.#.#.#####.###.#.###.#.#.#.#.#
##...#.....#.#.#.....#.#...........#.#...#...#.#.#
##.#.#.###.#.###.#####.###############.#######.#.#
##.#.....#.#.#...#...#.#.........#.....#...#.....#
##.#######.#.#.###.#.#.#.#######.#.#####.#.#.#####
##...#.....#.#...#.#...#.#.........#.....#.#...#.#
####.#.#####.#.#.#.#####.###########.#.#######.#.#
##...#.....#.#.#.......#.......#.....#.#.....#.#.#
##.#######.#.#################.#######.#.###.#.#.#
##.......#...#.....#.........#.......#.#.#.#.#.#.#
########.#####.###.#.#######.#####.#.#.#.#.#.#.#.#
##...#...#.......#...#...........#.#.#.#...#.#.#.#
##.#.#.###.#####.#.#############.###.#.###.#.#.#.#
##.#...#...#...#.#.#.......#...#.....#.#...#.#.#.#
##.#######.#.#.#.#.#.#####.#.#.#######.#.###.#.#.#
##...#...#.#.#.#.#.#.....#.#.#.........#.#.#...#.#
####.#.#.###.#e#.#.#####.#.###.#.#.#####.#.#####.#
##.#.#.#...#.#...#.....#.#...#.#.#.#...#.#...#...#
##.#.#.###.#.###########.###.###.#.#.#.#.#.#.#.#.#
##...#...#...#.............#...#.#.#.#...#.#.#.#.#
##.###.#.#####.###############.#.#.#.#####.#.###.#
##...#.#.............#.......#.#.#.#.#.....#.....#
####.#################.#####.#.#.###.#.#########.#
##.....................#.......#.......#.........#
##################################################
