###############################################
#.....#.........s.#....#....#.....#...#....#..#
##.#.#..#####.#.....##..#.#..#.##...##..##...##
#...#..#....#..#.###..#.#..#...#.##.#..#.##.#.#
#.#..#.#.#.###..#..##...##..##.#..#.#.#.......#
#.#.#..#.#..###..#....##...#...#.##..#.#.##.#.#
##..#.#...#..#..#..#.##..#.#.##..#.#....#....##
#..##..##.#.#..#.#..##..#..#.#.#....###..#.#..#
#.#..#.##..#..#...#...#..##..#.#.##....#.#.#.##
#..#.....#..#.###..##.#.#...#..#..###.#..#.#..#
##...#.#..#.#...#.#.#..##.##..#.#...#..#..###.#
#..##.###....##.#.#..#.#..#..#..###..#..#..#..#
#.#....#.###.#..#...#..#.###.##.....#..#.#.##.#
##..##.....#.#.#..#...#..##...#.####..#..#....#
#..#...###.#.#.#.#..##..#...#.......#...#.#.#.#
#.#.###....###..#..#.#.#.####.#####.#.#.#..#..#
#.#....#.##...#.#.#....#.....#.....#..#.#.#..##
#...##.#..#.#...#...##..#.##...###...#....#.#.#
#.##...##.#..###.###..##....###...###..##.#.#.#
#.#..##.#...#.......#....##...###.....#..#..#.#
#.#.#....#.#.#.####.#.###..##...#.####..#..#..#
#.#.#.##..#....#...##.#...#..##..##....#..#.#.#
##..#...#.##.#...#.#..#.#...#..#....##...##...#
#..#..#.#...#.###..#.#...##..#..#####.#.##..#.#
#.#..#...##.....#.#..##.#.##..#........#...#..#
#.#.#..#...####.#.#.#...#..#.###.#.#.#.##.##.##
#..#..####.#..#...#...####.#..#...#..#...#....#
##..#..#...#.#.##..###..#..#.#..#.#.#.##.#.##.#
###.##.#.##......#...##..#.#..#####.#....#.##.#
##...##....#.#.###.#..##...##...#...#.###....##
#..#..#.####..#.....##...#...##...#.#...####.##
##..#.#.....#...#.#..#.##..#...###.#.##....#..#
#.#.#.#.###.#.##.#.#.#...##.#.#......#.###..#.#
#...#.#.#.#..#......###.#.......#.##......#...#
####..#.#..#...#.##..#..#.####.#.#.###.#.#..#.#
#....#..#.#####...#.##.##....###......#..#.#.##
#.###.#.#..#...#.#..#..#.###....##.##...#..#..#
#.#.......#..#..#..#..#..#..###...#...#..#.##.#
#.#.#####.##..#..#..#..#..#....##..###..##....#
#..#....#...#..#.#.#..#.#...####..#...#...##.##
##..#.#..##.##.#.#..#.#..#.##....#..#.#.#..#..#
#..#...#.##..#.#.##...##.#.#..#.##.#..#.##..#.#
##...###...#.#.#...###.....#.#.#...#.##...##..#
#e#.#...##.#.#..#.#....##.#..#...###...#.#...##
#..#..#.#..#..##...#.##...#.#..#.#..##.##..#.##
##...#....###....#...#..#.#...#....#......#...#
###############################################
