##########
#....#.#.#
#.#.#....#
#..#..#.##
#.##.#..##
#....##..#
#.#.#.s#e#
#.##..##.#
#....#...#
##########
