#########################
#..#.###.....##.....#...#
##....#..#.#....#.#..#.##
#..##...#...######.#...##
#.#..#.#..##....#...##..#
#..#....#.#..##...#.#.#.#
##..###.#.#.#######...#.#
#..#....#.#.###....##.#.#
#.##.###..#..#..##..#..##
##...#.#.###...##..#.#.e#
#..##..#..#.###...#...###
#.#..#..#.#.#..#.#..###.#
#..#...#..#..#.#..#.....#
##..##...#.#...#.#..##.##
###...##.#...#.#.#.#...##
##..#.#..#.##..#.#.#.#..#
#..#..#.#..#..#..##..##.#
#.#..##.###..##.#.#.#...#
###.#.......#...#...#.###
#...#.##.###..##.#.#....#
#.##...##....#......###.#
#...#.#...###.##.##.#.#.#
#.#.###.##......#...#.#.#
#.s........##.#...##....#
#########################
