##################################################
##################################################
##.....#.......#.....#...#.#.....................#
##.###.#.#####.#.#.#.#.#.#.#.###################.#
##.#...#.#...#...#.#...#...#...#.....#.....#...#.#
##.#.###.###.#####.#######.###.#####.#.###.#.#.#.#
##.#.............#.#.....#...#...#e..#...#...#.#.#
####.#########.###.#.###.###.###.#.#.###.#####.#.#
##.#.#...#...#.#...#.#.#.#...#...#.#.#.#.#.....#.#
##.###.#.###.#.#.###.#.#.#####.###.#.#.#.#.#####.#
##.....#...#...#.....#.#.......#...#...#.#.......#
##########.#.#########.#########.#######.###.#####
##...#.....#.#.....#.....#.......#...#...#...#...#
##.#.#.#####.###.#.#.###.#####.#.#.#.#.#######.#.#
##.#.#...#.......#.#...#.#...#.#.#.#.#.........#.#
##.#####.#########.###.#.#.#.#.#.#.#.###########.#
##.....#...#.....#.#...#.#.#...#.#.#.#.........#.#
##.#.#####.#.#####.#.###s#.###.###.#.#.#######.#.#
##.#.....#.#.#...#...#...#.#...#...#...#...#.....#
##.#####.#.#.#.#.#####.###.###.#.###.###.#.#####.#
##.#.....#.#.#.#...#...#.....#.#...#.#...#.....#.#
##.#.#.###.#.#.###.#.###.###.#.###.###.#######.#.#
##.#.#.#...#...#.#.#.#.....#.#...#.......#.....#.#
##.#.#.#.###.###.#.#.#######.###.#########.#####.#
##.#.#.#.#.#...#.#...#.....#.#...#...#.....#.#...#
####.#.#.#.###.#.#####.###.#.###.###.#.#####.#.###
##...#.#.#.........#...#...#...#...#.#.#.....#...#
##.###.#.#.#######.###.#.###.#.###.#.#.#####.###.#
##.#...#.#...#...#.....#.#...#...#...#.....#.....#
##.#####.#####.#.#######.#.#####.#####.###.#.#####
##.....#.......#.....#...#...#...#...#.#...#.#...#
##.###.#############.#.#######.#.#.#.#.#.#####.#.#
##.#...#...........#.#.#...#...#.#.#.#.#.......#.#
##.#.#.#.#########.#.#.#.#.#.#####.#.#########.#.#
##.#.#.#.#.......#...#...#...#.....#.........#.#.#
##.#.###.#####.#.###########.#.#############.###.#
##.#...#.......#...#...#...#.#.#.....#.....#...#.#
##.###.###########.#.#.###.#.#.#.#####.###.###.#.#
##.#.#...........#...#...#...#.#.#...#.#.#.....#.#
##.#.#########.#########.#####.#.#.#.#.#.#######.#
##...#.....#.#.#.......#.......#...#.#.#.....#...#
####.#.###.#.#.#.#####.#########.###.#.#.###.###.#
##.#...#.....#...#...#.........#.#.#...#...#.....#
##.###.###########.#.#######.###.#.#######.#######
##...#.#.......#...#.........#...#.......#.......#
##.#.#.#.#####.#.#.#######.###.#######.#.#####.#.#
##.#.#.#...#.....#.#.....#.#...#.......#.#...#.#.#
##.###.###.#########.###.###.#####.#####.#.#.###.#
##.......#.............#...........#.......#.....#
##################################################
