##########
##########
##..s..#.#
##.#####.#
##.....#.#
######.#.#
##e....#.#
##.#####.#
##.......#
##########
