#########################
#......#...#.....#....#.#
#.####...#.###.#..#.#...#
#.#...#.##...#..#..#..#.#
#...#.#...##.##..#...#..#
####...##..#....#.###..##
#....###..#.#.##.....#.##
#.#.#...#.#..#...#.###..#
#..#..#...##..#.#......##
#.#..##.##.##....#.#.##.#
#..#...#......##..#.#...#
#.#.##.#.###.#.##.#...#s#
##......#...#...#..#.#..#
#..###.#..#..##..#...##.#
##...#..#..#.#..###.#...#
##.#..#.#.#..#.#.#.#.#.##
#..##.#.#.#.#........#.##
##..#..##.#.#.#.##.#.#..#
#..#.#....#..#e#...#.##.#
#.#..###.#.#...#.#.#..#.#
##..#...#...###..##..##.#
#..##.#..##.....#...#...#
#.##...#..#.####.###..#.#
#....#..#............#..#
#########################
