##########
#.#...#..#
#...#.#.##
##.##....#
##.#.#.#.#
#..#.s..##
#.#...#..#
#..#.##.##
##e#.....#
##########
