#########################
#.#....#......#...#.....#
#e..##.##.#.#.###..##.###
##.#.#...#..#....#..#...#
#.#...##..#.#.#.#.#...#.#
#...#.###...##..#.#.###.#
#.##...#####...#....#...#
#..#.#..#....##.##.#..#.#
##.#..#..#.##.#....#.#..#
#..###.#.#.#....#.##..#.#
#.#.....##..##.#..#.#.###
#...#.#...#...#..#..#...#
#.####.##..##..#...#.##.#
#...#....#...#.#.#....#.#
#.#.#.#.####.#..###.#.#.#
##..#.#..#...##..#..###.#
#..#...#.#.#...#.#.#....#
#.#.#.#..#..#.#..##..##.#
#.#....#.##.#.#.#...##..#
#..#.#.#..#..#...#.#...##
##.#.#..#..#.#.##..#.#..#
#...#..#..#..#...#..#.#.#
#.#..#.#.#..#.##.##.#...#
#..#...#s.#.........#.#.#
#########################
